********************************
********************************
********************************
***.....****.****.***.*.....****
***.*******.*.***..*..*.********
***.*...**.***.**.*.*.*.********
***.*...**.....**.***.*...******
***.***.*.*****.*.***.*.********
***.....*.*****.*.***.*.....****
********************************
***.....*.*****.*.....*....*****
***.***.*.*****.*.*****.***.****
***.***.**.***.**.*****....*****
***.***.**.***.**...***.*.******
***.***.***.*.***.*****.**.*****
***.....****.****.....*.***.****
********************************
********************************
********************************
............*****...............
...........*..p..*..............
...........*.....*..............
********************************