********************************
********************************
********************************
.*****.....*.*****.*.....*.*****
.*****.*****.*****.*.*****.*****
.*****.******.***.**.*****.*****
.*****...****.***.**...***.*****
.*****.*******.*.***.*****.*****
.....*.....****.****.....*.....*
********************************
********************************
************.........***********
************.*******.***********
************.*******.***********
************.........***********
********************.***********
********************.***********
************.........***********
********************************
............*****...............
...........*..p..*..............
...........*.....*..............
********************************
