*******************************
*******************************
***.*****.....*.*****.*.....*.****
***.*****.*****.*****.*.*****.****
***.*****.******.***.**.*****.****
***.*****...****.***.**...***.****
***.*****.*******.*.***.*****.****
***.....*.....****.****.....*.....
*******************************
*******************************
*******************************
*************p*****************
*************.*****************
*******************************
*******************************
*******************************
*******************************
*******************************
*******************************