********************************
********************************
********************************
.*****.....*.*****.*.....*.*****
.*****.*****.*****.*.*****.*****
.*****.******.***.**.*****.*****
.*****...****.***.**...***.*****
.*****.*******.*.***.*****.*****
.....*.....****.****.....*.....*
********************************
*************........***********
************..****..************
***********..****..*************
****************..**************
***************..***************
**************..****************
*************..*****************
************.........***********
********************************
............*****...............
...........*..p..*..............
...........*.....*..............
********************************